%%%%%%%%%%%%%%%%
%D.............%
%.%%%.%..%.%%%.%
%..............%
%..............%
%.C.....E...C..%
%..............%
%^^^^...^^^^^^^%
%..............%
%..E...........%
%..............%
%..........E...%
%..............%
%%%%%%%%%%%%%%%%
