%%%%%%%%%%
%D......%%
%..C..%.%%
%*%%%..%%%
%*%%...%%%
%*%%....%%
%*%..E...%
%**..E...%
%%%%%%%%%%
