%%%%%%%%%%
%DE......%
%..%.%...%
%........%
%..%.%...%
%C...E..C%
%%%%%%%%%%
