%%%%%%%%%
%D......%
%..%%...%
%...%..C%
%..%%...%
%.E.E...%
%%%%%%%%%
