%%%%%%%%%%%%
%D.........%
%..%.%%.%..%
%..%....%..%
%.%%.%%.%%.%
%..C.C..E.E%
%%%%%%%%%%%%
