%%%%%%%%%%%%%
%D..........%
%...........%
%^^^^.^^^^^^%
%...E..^^...%
%.....%%....%
%.....%%....%
%........E..%
%....CCC....%
%%%%%%%%%%%%%
