%%%%%%%%
%D.E..C%
%.%....%
%......%
%.%....%
%C.E...%
%%%%%%%%
