%%%%%%%%%%
%D~~~....%
%.~%~%%.%%
%.~%....E%
%.~%.%%..%
%........%
%..%..C..%
%....E...%
%%%%%%%%%%
