%%%%%%%%%%%%
%D...^.....%
%.....^..E.%
%..E..^....%
%.....^....%
%C....^.C..%
%....^^^...%
%%%%%%%%%%%%
