%%%%%%%%
%E.^^..%
%^^^^^^%
%C.^...%
%..^..C%
%..^^^.%
%..^^.E%
%....D.%
%%%%%%%%
