%%%%%%%%
%D....E%
%..%%~~%
%......%
%~~%%..%
%E.C..E%
%%%%%%%%
