%%%%%%%%%%%%%%%%%%%
%D....%...%...%..E%
%%%.%.%.%.%.%.%..%%
%................%%
%.%~%.%~%.%~%.%%.%%
%E%.%E%.%.%.%.%..%%
%~%.%~%.%~%.%~%..%%
%.....%.........%%%
%.%.%.%.%E%.%.%..%%
%C..%...%...%....E%
%%%%%%%%%%%%%%%%%%%
