%%%%%%%%%%%%
%D...~.....%
%..%.~.....%
%.E%.~~....%
%..%...^^..%
%......^^.E%
%..C...^^..%
%.......%..%
%..E......E%
%......C...%
%%%%%%%%%%%%
