%%%%%%%
%D...E%
%..%..%
%..C..%
%...E.%
%%%%%%%
