%%%%%%%%%%
%D.......%
%........%
%***^^***%
%........%
%.....C..%
%........%
%..E.....%
%.....E..%
%%%%%%%%%%
