%%%%%%%%%
%D.E..~.%
%.%~..%.%
%..~....%
%.%..^%.%
%.E.^.C.%
%%%%%%%%%
