%%%%%%%%%%
%D.~.C.E.%
%.~~.~~~~%
%~~..~~..%
%E~.....~%
%..~~..~E%
%.C~~~~~~%
%%%%%%%%%%
