%%%%%%%%%%%%
%D...E.....%
%..........%
%^^~~~~~~^^%
%..........%
%..C...E...%
%..........%
%..........%
%.....C....%
%%%%%%%%%%%%
