%%%%%%%
%C...E%
%.%%%.%
%.%%%.%
%.%%%.%
%D....%
%%%%%%%
