%%%%%%%%%%%%
%D.%......E%
%..%......%%
%^^^^^^^^^^%
%..%......%%
%C.%...C..%%
%%%%%%%%%%%%
