%%%%%%%%%%%%%%%
%B..~...E.B...%
%..~..........%
%......^^.....%
%...E.........%
%...........B.%
%.B...........%
%........E....%
%......^^.....%
%..~..........%
%..E.........E%
%%%%%%%%%%%%%%%
---
drone:1:capacity=4,battery=30
drone:2:capacity=3,battery=30
drone:3:capacity=6,battery=30
drone:4:capacity=5,battery=30
delivery:1:weight=4,window=0-20
delivery:2:weight=3,window=0-20
delivery:3:weight=5,window=0-20
delivery:4:weight=4,window=0-25
delivery:5:weight=2,window=0-25
