%%%%%%%%%%%%%
%B.........E%
%...........%
%..~~~~~....%
%..~~~~~....%
%...........%
%E.........B%
%%%%%%%%%%%%%
---
drone:1:capacity=5,battery=32
drone:2:capacity=5,battery=32
delivery:1:weight=3,window=0-50
delivery:2:weight=3,window=0-50
