%%%%%%%%%%
%B......E%
%........%
%........%
%.E...E.B%
%%%%%%%%%%
---
drone:1:capacity=5,battery=30
drone:2:capacity=7,battery=30
delivery:1:weight=2,window=0-20
delivery:2:weight=4,window=0-20
delivery:3:weight=3,window=0-20
