%%%%%%%%%%%
%B.~.....E%
%.%..%..%.%
%B..~....E%
%.%..%..%.%
%B..~....E%
%%%%%%%%%%%
---
drone:1:capacity=10,battery=80
drone:2:capacity=10,battery=80
drone:3:capacity=10,battery=80
delivery:1:weight=5,window=0-50
delivery:2:weight=4,window=5-40
delivery:3:weight=6,window=0-60
