%%%%%%%%%%%
%B..^^^..E%
%..^^^^^..%
%..^^^^^..%
%..........%
%..........%
%%%%%%%%%%%
---
drone:1:capacity=5,battery=28
delivery:1:weight=3,window=0-40
