%%%%%%%%%%%%%
%B%%E%%E%%E%%
%...........%
%%%%%%%%%%%%%
---
drone:1:capacity=8,battery=50
drone:2:capacity=5,battery=50
delivery:1:weight=2,window=0-60
delivery:2:weight=3,window=0-60
delivery:3:weight=3,window=0-60
