%%%%%%%%%%%%%
%B......E..E%
%...........%
%B..........%
%...E.......%
%%%%%%%%%%%%%
---
drone:1:capacity=5,battery=60
drone:2:capacity=5,battery=60
delivery:1:weight=2,window=0-10
delivery:2:weight=2,window=15-30
delivery:3:weight=2,window=5-20
