%%%%%%%%%%%%
%....E....E%
%..........%
%*****..***%
%*****..***%
%..........%
%B........B%
%%%%%%%%%%%%
---
drone:1:capacity=5,battery=24
drone:2:capacity=5,battery=24
delivery:1:weight=2,window=1-20
delivery:2:weight=2,window=1-20
