%%%%%%%%%%
%B......B%
%..E...E.%
%.......E%
%....E...%
%%%%%%%%%%
---
drone:1:capacity=5,battery=80
drone:2:capacity=7,battery=80
delivery:1:weight=3,window=0-80
delivery:2:weight=2,window=0-80
delivery:3:weight=4,window=0-80
delivery:4:weight=3,window=0-80
