%%%%%%%%%%
%B.E.%...%
%....%...%
%....%...%
%...E....%
%....%...%
%....%E.B%
%%%%%%%%%%
---
drone:1:capacity=5,battery=20
drone:2:capacity=5,battery=20
delivery:1:weight=2,window=1-4
delivery:2:weight=3,window=6-20
delivery:3:weight=2,window=1-4
