%%%%%%%%%%%
%B.......E%
%.%..%..%.%
%B.......E%
%.%..%..%.%
%B.......E%
%%%%%%%%%%%
---
drone:1:capacity=10,battery=50
drone:2:capacity=10,battery=50
drone:3:capacity=10,battery=50
delivery:1:weight=4,window=0-30
delivery:2:weight=5,window=0-35
delivery:3:weight=3,window=0-25
