%%%%%%%%%%%%%
%B.......E.E%
%...........%
%B.......E..%
%...........%
%B..........%
%%%%%%%%%%%%%
---
drone:1:capacity=3,battery=50
drone:2:capacity=4,battery=50
drone:3:capacity=6,battery=50
delivery:1:weight=3,window=0-100
delivery:2:weight=4,window=0-100
delivery:3:weight=2,window=0-100
